reviews,score,cleanliness,communication,checkIn,accuracy,location,value
8,2,1,1,4,4,2,3
9,3,3,1,4,5,4,2
3,5,1,4,4,2,3,1
9,2,2,5,5,4,2,5
10,1,0,2,2,5,5,1
6,4,0,2,5,2,5,5
6,0,5,4,0,0,3,5
0,5,5,1,5,2,4,2
1,0,4,2,5,3,5,4
0,2,2,1,3,2,5,5
7,2,1,5,4,5,5,1
8,3,0,3,2,1,5,3
1,5,1,5,1,2,5,3
8,4,5,2,1,5,2,4
4,1,0,5,5,0,5,3
8,4,0,4,0,2,4,5
8,0,1,3,3,0,1,2
8,3,4,2,0,3,5,4
4,4,1,4,5,2,5,3
2,2,0,1,5,4,0,2
3,3,2,2,2,4,2,1
0,4,2,2,2,5,4,5
9,1,3,0,1,3,1,2
9,4,1,0,5,2,1,2
4,2,4,0,0,5,2,5
9,4,5,0,1,4,2,1
8,5,4,3,5,2,0,3
10,2,2,1,4,2,3,4
1,2,1,3,0,1,0,3
5,0,4,4,5,5,4,2
2,1,5,1,4,4,2,1
1,1,0,4,3,1,4,1
10,5,4,2,2,4,0,1
5,1,0,1,0,0,4,3
6,2,0,0,0,4,1,0
10,4,1,0,3,3,2,1
6,4,5,3,2,0,1,2
7,1,3,1,2,0,3,5
1,4,5,4,2,3,4,3
3,1,2,3,2,4,4,0
8,5,3,2,0,2,1,1
3,5,2,0,5,0,2,1
4,4,4,4,4,5,3,5
6,3,5,1,5,5,5,2
1,4,1,5,5,3,2,2
7,4,3,5,4,1,0,3
7,2,0,4,2,5,3,1
0,1,3,1,5,0,5,2
7,5,5,0,4,2,5,2
4,2,4,5,1,2,3,0
8,5,0,2,5,4,5,2
10,2,1,5,0,4,2,4
2,0,3,1,2,0,0,5
4,1,4,5,3,1,4,2
6,5,0,1,5,3,3,5
9,3,2,0,2,5,0,0
4,0,4,2,5,2,1,4
2,4,5,3,1,4,3,0
7,3,1,0,1,0,1,2
4,4,2,4,3,3,2,4
8,0,2,2,2,5,1,3
9,5,4,2,2,4,4,5
8,4,1,1,0,5,2,3
5,2,0,0,0,2,5,5
9,3,0,2,5,4,2,4
10,0,4,1,4,4,2,3
3,2,3,0,3,0,4,1
6,2,0,1,5,5,5,5
4,4,2,4,2,3,0,0
9,5,4,1,3,4,3,0
6,5,3,3,0,3,4,3
6,2,2,2,3,3,0,4
0,2,3,0,1,4,3,0
8,2,5,3,0,2,1,0
3,3,4,4,5,1,0,1
4,2,1,3,1,5,5,0
10,1,0,0,4,4,5,1
7,4,2,2,4,4,3,5
0,3,4,2,2,3,2,4
10,4,2,2,4,3,5,3
9,3,3,5,0,5,0,2
6,3,1,2,5,3,2,1
9,5,3,2,5,2,4,1
4,3,4,4,5,3,5,5
4,1,5,3,0,5,4,1
0,4,2,2,4,1,0,2
10,4,5,4,0,2,0,2
1,1,3,1,0,4,1,5
9,4,4,0,2,0,4,3
1,4,0,2,3,5,2,5
5,5,3,1,0,5,4,3
1,3,3,2,2,3,3,0
1,5,4,4,3,0,0,4
9,5,0,0,5,2,3,1
8,1,3,2,5,0,1,0
6,4,3,0,1,4,4,5
5,4,0,4,5,4,3,2
2,5,1,3,2,2,5,3
1,4,4,1,0,2,4,4
2,2,2,5,4,2,0,4
